111111111111111111111111111111
11101111C0000C0000000000000011
110000000000C000X000000000E011
1100111110000C00000X0000000011
1100000000000C0000X000X0000011
11C0000000000000000000C000P011
11C0000000000000000000C0000011
111111111111111111111111111111
